NO ./texture/north.xpm
SO ./texture/south.xpm
EA ./texture/east.xpm
WE ./texture/west.xpm

F 0,0,0
C 255,255,255

11111111111
1N000000001
10000001001
11000001001
11111111111

