NO ./texture/north.xpm
SO ./texture/south.xpm
EA ./texture/east.xpm

F 0,0,0
C 0,0,0

11111111
10000001
100NN001
11000001
11111111


WE ./texture/west.xpm