1111111
11CPE01
1000001
1000000
1111111