111111111111111111111
11111111E111111111111
10000C0000000000000C1
100C00000000C00000001
1000000000C00000000C1
1C000000000C000000001
1000000000000000000C1
1000C0000C000000C0001
1C0000000000000C00001
100C0000000000C000001
10000000P000000000001
111111111111111111111