1111111111111111111111
1100000000000000000001
11P0000000000000000001
1EC0000000000000000001
1111111111111111111111
